00000##00000##00000
0000#00#0#0#00#0000
00000##00#00##00000
0000000000000000000
0000000#####0000000
