000000##0000##00000
###00#00000000#0###
#0#00###0000###0#0#
###00#00000000#0###
000000##0000##00000
