00#00#000###0##0###
0#0#0#000#000#0#0#0
0###0#000###0##00#0
0#0#0###0#000#0#0#0
000000000###0000000
