0000#00#####00#0000
000#00#00000#00#000
0000#00#####00#0000
0000000000000000000
0000000000000000000
