00#000#00#00#000#00
000###0##0##0###000
000000#00#00#000000
000000000#000000000
0000000000000000000
