0#0#0#0#000#0#0#0#0
00#000#0#0#0#000#00
0000000#0#0#0000000
00000000#0#00000000
000000000#000000000
