0000000000000000000
0#000#000#000#000#0
#0#0#0#0#0#0#0#0#0#
0#000#000#000#000#0
0000000000000000000
