000##000000000##000
0000##0#0#0#0##0000
00000#########00000
000000###0###000000
0000000#000#0000000
