0#00000#00000#####0
0#00#00#0###00#0#00
0#0###0#000000#0#00
0#00#00#0###00#0#00
0#00000#00000#####0
